1101000011
1101011011
1000011011
0011011010
0011011000
1011000011
0000111011
1110111001
0000011101
0011000001
